1111111111
1000000001
10C000C001
1000000001
100P000001
1000000001
10C000C001
1000000001
10E000E001
1111111111
